Big thanks to:-

gibbo912
Partybiber
xbfletch99
Darth Ash 
nufc4ever 
matty81 
mick4774
jimmmyczz
xboxrob 
smicer07
Reaper
treebeard59
Ian Scott
Tricky
Compulsion
delpiero


Version 4
---------

Fixed Netherlands player names, commentary and shirt names
Fixed Germany player names, commentary and shirt names
Fixed various International player names, commentary and shirt names
Fixed various International kits
Fixed all Bundeslige badges
Fixed flags so that they look like flags!


Version 5
---------

Fixed all players names, including commentary and Shirts
Fixed all International and Club kits
Fixed all club badges
Fixed all club flags
Fixed all PES Shop Player Names
Fixed all Classic teams player names
Updated many squads, Line-ups and formations
Updated various player's likenesses within the game:-

Almunia 	Arsenal
Anastasiou	Ajax
Angel 	Aston Villa
Arveladze	Rangers
Babayaro 	Chelsea
Baros	Liverpool
Barry 	Aston Villa
Bartlett 	Charlton
Beattie	Southampton
Bellamy	Newcastle
Berbatov	Leverkusen
Bergkamp	Arsenal
Biscan	Liverpool
Blasi	Juventus
Bouma	PSV
Butt	Newcastle
Cahill 	Everton
Campbell 	Arsenal
Carew	Besiktas
Carragher	Liverpool
Carsley 	Everton
Carvalho	Chelsea
Castelen	Feyenord
Cavenaghi	Spartak Moscow
Cech	Chelsea
Cudicini 	Chelsea
Davids Edgar	Inter
de Jong	PSV
De Ridder	Ajax
Defoe	Tottenham
Del Piero	Juventus
Dickov 	Blackburn
Diouf 	Bolton
Drogba	Chelsea
Edu	Arsenal
Edu	Arsenal
Emerton 	Blackburn
Eremenko	Lecce
Escude	Ajax
Eto'o	Barcelona
Ferdinand	Man Utd
Ferguson	Blackburn
Fletcher	Man Utd
Flitcroft 	Blackburn
Flo	Norway
Forssell	Birmingham
Fowler	Man City
Friedel	Blackburn
Frings	Bayern Munich
Galasek	Ajax
Gamst Pedersen 	Blackburn
Giggs	Man Utd
Grainger	Birmingham
Gray 	Blackburn
Grygera	Ajax
Gudjohnsen	Chelsea
Hakan Sukur	Galatasaray
Hargreaves	Bayern Munich
Hartson	Celtic
Hasan Sas	Galatasaray
Hasselbaink	Middlesborough
Heinze	Man Utd
Henchoz	Liverpool
Hendrie 	Aston Villa
Henry	Arsenal
Holland 	Charlton
Horsfield	WBA
Howard	Man Utd
Huth	Chelsea
Hyypia	Liverpool
James	Man City
Jenas	Newcastle
Johansson 	Charlton
Johnsen E.	Norway
Johnsen F.	Norway
Johnson	Chelsea
Johnson	Crystal Palace
Júlio César 	Bolton
Juninho	Celtic
Kahn	Bayern Munich
Kahn	Bayern Munich
Karagounis	Inter
Kaviedes	Crystal Palace
Keane	Tottenham
Kiely 	Charlton
Kilbane	Everton
Kirkland	Liverpool
Kolkka 	Crystal Palace
Kuyt	Feyenord
Litmanen	Finland
Lualua	Portsmouth
Luis Garcia	Liverpool
Lundekvam	Southampton
Lupoli 	Arsenal
Makélélé 	Chelsea
Mancini	Roma
Maxwell	Ajax
McCann 	Aston Villa
McFadden 	Everton
Mellberg 	Aston Villa
Moore, Luke 	Aston Villa
Morrison 	Birmingham
Murphy 	Charlton
Nedved	Juventus
Niemi	Southampton
Okocha 	Bolton
Oliseh	Borussia Dortmund
Ooijer	PSV
Osman 	Everton
Pahars	Southampton
Parker 	Chelsea
Pasanen	Werder Bremen
Pennant 	Arsenal
Prso	Rangers
Purse	WBA
Quashie	Portsmouth
Rehman 	Fulham
Reid	Blackburn
Riihilahti 	Crystal Palace
Riquelme	Villareal
Robert	Newcastle
Roberto Carlos	Real Madrid
Rommedahl 	Charlton
Ronaldo	Man Utd
Ronaldo	Real Madrid
Rooney	Man Utd
Rosicky	Borussia Dortmund
Routledge	Crystal Palace
Sagnol	Bayern Munich
Saha	Man Utd
Santa Cruz	Bayern Munich
Savage	Birmingham
Schweinsteiger	Bayern Munich
Shearer	Newcastle
Short 	Blackburn
Silvestre	Man Utd
Sneijder	Ajax
Solano 	Aston Villa
Sonck	Ajax
Sörensen 	Aston Villa
Speroni	Crystal Palace
Stead 	Blackburn
Stepanovs	Latvia
Strand	Norway
Tevez	Boca
Tiago	Chelsea
Todd 	Blackburn
Torres	Atletico Madrid
Tugay 	Blackburn
Umit Karan	Galatasaray
V. O. Hesselink	PSV
Van Hooijdonk	Netherlands
Vaz Te 	Bolton
Xabi Alonso	Liverpool
Young 	Charlton
Zenden	Middlesborough


Big thank you to delpiero for allowing us to edit playerlikenesses using his data
Big thank you to Pesfan for allowing us to use edit some of their original data
Big thank you to Compulsion for his brilliant editor


Enjoy

Borag Thung